######################################################################################################################################################################
######################################################################################################################################################################
######################################################################################################################################################################
######################################################################################################################################################################
######################################################################################################################################################################
######################################################################################################################################################################
######################################################################################################################################################################
######################################################################################################################################################################
######################################################################################################################################################################
######################################################################################################################################################################
######################################################################################################################################################################
######################################################################################################################################################################
######################################################################################################################################################################
######################################################################################################################################################################
######################################################################################################################################################################
######################################################################################################################################################################
######################################################################################################################################################################
######################################################################################################################################################################
######################################################################################################################################################################
######################################################################################################################################################################
######################################################################################################################################################################
######################################################################################################################################################################
######################################################################################################################################################################
######################################################################################################################################################################
######################################################################################################################################################################
######################################################################################################################################################################
######################################################################################################################################################################
######################################################################################################################################################################
######################################################################################################################################################################
######################################################################################################################################################################
##############################                                                     +----+                                               ##############################
##############################                                                     |    |                                               ##############################
##############################                                                     +----+                                               ##############################
##############################                                                                                                          ##############################
##############################                                                                                                          ##############################
##############################                                                                                                          ##############################
##############################                                                                                                          ##############################
##############################                +----------------+                                                                        ##############################
##############################                |                |                                                                        ##############################
##############################            +---+                |                                                                        ##############################
##############################                                 +----------------+                                                       ##############################
##############################            +---+                                 |                                                       ##############################
##############################                |                                 |                                                       ##############################
##############################                |                       +---------+                                                       ##############################
##############################                |                       |                                                                 ##############################
##############################                +-----------------------+       +------+                                                  ##############################
##############################                                                |      |                                                  ##############################
##############################                                                |      |                                                  ##############################
##############################                                                |      |                                                  ##############################
##############################                                                |      |                                                  ##############################
##############################                                                +------+                                                  ##############################
##############################                                                                                                          ##############################
##############################                                                                                                          ##############################
##############################                                                                                                          ##############################
##############################                                                                                                          ##############################
##############################                                                                                                          ##############################
##############################                                                                                                          ##############################
##############################                                                                                                          ##############################
##############################                                                                                                          ##############################
##############################                                     +----------+                                                         ##############################
##############################                                     |          |                                                         ##############################
##############################                                     |          |                                                         ##############################
##############################                                     |          |                                                         ##############################
##############################                                     |          |                                                         ##############################
##############################                            +---+ +--+          +--+ +--+                                                 ##############################
##############################                            |                           |                                                 ##############################
##############################                            |                   +-------+                                                 ##############################
##############################                            |                   |                                                         ##############################
##############################                            |                   |                                                         ##############################
##############################                            |                   |                                                         ##############################
##############################                            |                   |                                                         ##############################
##############################                            +-------------------+                                                         ##############################
##############################                                                                                                          ##############################
##############################                                                                                                          ##############################
##############################                                                                                                          ##############################
##############################                                                                                                          ##############################
##############################                                                                                                          ##############################
##############################                                                                                                          ##############################
##############################                                                                                                          ##############################
##############################                                                                                                          ##############################
##############################                                                                                                          ##############################
##############################                                                                                                          ##############################
##############################                                                                                                          ##############################
##############################                                                                                                          ##############################
##############################                                                                                                          ##############################
##############################                                                                                                          ##############################
##############################                                                                                                          ##############################
##############################                                                                                                          ##############################
######################################################################################################################################################################
######################################################################################################################################################################
######################################################################################################################################################################
######################################################################################################################################################################
######################################################################################################################################################################
######################################################################################################################################################################
######################################################################################################################################################################
######################################################################################################################################################################
######################################################################################################################################################################
######################################################################################################################################################################
######################################################################################################################################################################
######################################################################################################################################################################
######################################################################################################################################################################
######################################################################################################################################################################
######################################################################################################################################################################
######################################################################################################################################################################
######################################################################################################################################################################
######################################################################################################################################################################
######################################################################################################################################################################
######################################################################################################################################################################
######################################################################################################################################################################
######################################################################################################################################################################
######################################################################################################################################################################
######################################################################################################################################################################
######################################################################################################################################################################
######################################################################################################################################################################
######################################################################################################################################################################
######################################################################################################################################################################
######################################################################################################################################################################
######################################################################################################################################################################