############################################################################################################
############################################################################################################
############################################################################################################
############################################################################################################
############################################################################################################
############################################################################################################
############################################################################################################
############################################################################################################
############################################################################################################
############################################################################################################
############################################################################################################
############################################################################################################
############################################################################################################
############################################################################################################
############################################################################################################
#                                                     +----+                                               #
#                                                     |    |                                               #
#                                                     +----+                                               #
#                                                                                                          #
#                                                                                                          #
#                                                                                                          #
#                                                                                                          #
#                +----------------+                                                                        #
#                |                |                                                                        #
#            +---+                |                                                                        #
#                                 +----------------+                                                       #
#            +---+                                 |                                                       #
#                |                                 |                                                       #
#                |                       +---------+                                                       #
#                |                       |                                                                 #
#                +-----------------------+       +------+                                                  #
#                                                |      |                                                  #
#                                                |      |                                                  #
#                                                |      |                                                  #
#                                                |      |                                                  #
#                                                +------+                                                  #
#                                                                                                          #
#                                                                                                          #
#                                                                                                          #
#                                                                                                          #
#                                                                                                          #
#                                                                                                          #
#                                                                                                          #
#                                                                                                          #
#                                     +----------+                                                         #
#                                     |          |                                                         #
#                                     |          |                                                         #
#                                     |          |                                                         #
#                                     |          |                                                         #
#                            +---+ +--+          +--+ +--+                                                 #
#                            |                           |                                                 #
#                            |                   +-------+                                                 #
#                            |                   |                                                         #
#                            |                   |                                                         #
#                            |                   |                                                         #
#                            |                   |                                                         #
#                            +-------------------+                                                         #
#                                                                                                          #
#                                                                                                          #
#                                                                                                          #
#                                                                                                          #
#                                                                                                          #
#                                                                                                          #
#                                                                                                          #
#                                                                                                          #
#                                                                                                          #
#                                                                                                          #
#                                                                                                          #
#                                                                                                          #
#                                                                                                          #
#                                                                                                          #
#                                                                                                          #
#                                                                                                          #
############################################################################################################
############################################################################################################
############################################################################################################
############################################################################################################
############################################################################################################
############################################################################################################
############################################################################################################
############################################################################################################
############################################################################################################
############################################################################################################
############################################################################################################
############################################################################################################
############################################################################################################
############################################################################################################
############################################################################################################